111111111111111
1E00000000P0001
100000000C00001
100000000000001
100010000000001
10000000C000001
10C000000000001
1100E0001000001
111111111111111
110000001000001
101010101010101
111111111111111
111111111111111
111111111111111
111111111111111
111111111111111
