11111111111111111111111111111111111111111
1C000000000000000000P00000000000000000001
11111111111111111111111111111111111111101
1C000000000000000000000000000010000000101
11101111111011111111000000000010101110001
1C1010000000000111E1110000000000100011111
10101000000000010000010000000011111000001
10101000000000011000110000000000001110001
10000000000000000000000000000000000000001
10101000000000011111111111100000000000001
101C100000000000000000000C100000000000001
10111011111111111111111111100000000000001
10000000000000000000000000000000000000001
11111111111111111111111111111111111111111
