1111111
1PC10E1
10CC001
1111111
