111111111111111
100000000000001
10000E0010P0001
100000000000001
100000000000001
100000000000001
100010001000001
100000000000001
111111111111111
