111111111111111
100000000000001
100000000000001
100000000000001
100000000000001
100000000000001
100000000000001
10C0000000P0001
111111111111111
